nr,spelare,pos,gp,g,a,tp,pim,gwg,ppg,sog,hits,bks,+,-,+/-,toi/gp,team
67.0,*Leon Bristedt*L Bristedt,F,46,14,32,46,78,2,4,93,33,22,43,24,19,17:04,Rögle BK
91.0,Adam TambelliniA Tambellini,F,39,24,19,43,6,5,11,135,14,9,42,18,24,17:56,Rögle BK
28.0,Anton BengtssonA Bengtsson,F,49,20,19,39,10,4,3,100,69,12,43,23,20,18:42,Rögle BK
16.0,*Lucas Ekeståhl-Jonsson*L Ekeståhl-Jonsson,D,52,7,29,36,20,2,4,93,18,45,44,35,9,20:36,Rögle BK
18.0,Dennis EverbergD Everberg,F,45,16,18,34,49,2,4,79,37,15,48,25,23,18:27,Rögle BK
12.0,Brady FergusonB Ferguson,F,52,6,17,23,18,2,0,74,18,27,37,25,12,17:53,Rögle BK
54.0,William WallinderW Wallinder,D,47,4,15,19,6,0,0,46,36,33,31,26,5,15:43,Rögle BK
40.0,*Oskar Stål-Lyrenäs*O Stål-Lyrenäs,F,47,8,10,18,4,1,1,70,8,14,18,22,-4,14:10,Rögle BK
61.0,Ludvig LarssonL Larsson,F,50,8,9,17,14,3,1,58,28,19,26,17,9,14:28,Rögle BK
6.0,Tony SundT Sund,D,45,6,10,16,20,0,0,69,59,37,36,21,15,20:02,Rögle BK
58.0,Ryan McKiernanR McKiernan,D,49,2,14,16,45,1,1,62,33,52,27,25,2,18:35,Rögle BK
22.0,Samuel JonssonS Jonsson,D,42,1,15,16,4,0,0,55,4,31,34,25,9,19:16,Rögle BK
72.0,*Daniel Zaar*D Zaar,F,16,3,12,15,4,0,0,31,4,9,13,8,5,18:02,Rögle BK
90.0,Ted BrithénT Brithén,F,25,4,8,12,6,2,1,32,8,15,15,16,-1,15:10,Rögle BK
24.0,Marco KasperM Kasper,F,46,7,4,11,17,1,1,55,34,14,15,25,-10,11:44,Rögle BK
27.0,Linus SjödinL Sjödin,F,49,5,6,11,6,1,0,34,20,15,17,17,0,11:59,Rögle BK
16.0,*Tyler Kelleher*T Kelleher,F,34,4,6,10,12,0,0,27,4,5,13,10,3,11:05,Rögle BK
34.0,Adam EdströmA Edström,F,43,7,2,9,6,3,0,62,74,19,17,15,2,13:34,Rögle BK
8.0,*Samuel Johannesson*S Johannesson,D,48,1,6,7,2,1,0,19,5,19,21,21,0,12:05,Rögle BK
7.0,Erlend LesundE Lesund,D,21,0,6,6,27,0,0,26,37,15,15,15,0,21:05,Rögle BK
73.0,*Valtteri Kemiläinen*V Kemiläinen,D,8,2,3,5,2,0,0,13,3,8,7,6,1,16:19,Rögle BK
11.0,*Mattias Sjögren*M Sjögren,F,44,1,4,5,18,1,0,20,49,13,7,27,-20,12:49,Rögle BK
86.0,*Éric Gélinas*É Gélinas,D,12,1,1,2,4,0,1,29,7,11,7,4,3,16:40,Rögle BK
17.0,*Philip Granath*P Granath,F,40,1,1,2,4,0,0,20,17,18,5,16,-11,7:22,Rögle BK
71.0,*Robert Lantosi*R Lantosi,F,6,1,0,1,0,0,0,10,0,1,2,2,0,10:07,Rögle BK
57.0,*Vojtech Mozik*V Mozik,D,13,1,0,1,2,1,0,22,8,14,5,5,0,16:35,Rögle BK
20.0,*Oliver Tärnström*O Tärnström,F,27,0,1,1,2,0,0,11,3,1,2,9,-7,6:08,Rögle BK
9.0,*Viktor Grahn*V Grahn,D,1,0,0,0,2,0,0,2,0,0,0,0,0,14:28,Rögle BK
33.0,*Oskar Asplund*O Asplund,D,1,0,0,0,2,0,0,0,0,0,0,0,0,9:22,Rögle BK
55.0,*Oscar Johnsson*O Johnsson,F,4,0,0,0,0,0,0,3,0,1,0,2,-2,3:38,Rögle BK
15.0,*Kevin Engvall*K Engvall,F,5,0,0,0,0,0,0,0,0,0,0,0,0,3:09,Rögle BK
71.0,*Kalle Bartholdsson*K Bartholdsson,D,5,0,0,0,0,0,0,0,0,0,0,1,-1,0:30,Rögle BK
55.0,William StrömgrenW Strömgren,F,6,0,0,0,0,0,0,2,1,0,0,1,-1,1:47,Rögle BK
32.0,*Oskar Hassel*O Hassel,D,22,0,0,0,2,0,0,3,3,2,2,4,-2,3:01,Rögle BK
67.0,Linus OmarkL Omark,F,52,21,37,58,32,5,7,118,2,11,40,29,11,20:13,Luleå Hockey
96.0,Pontus AndreassonP Andreasson,F,52,18,20,38,22,3,5,89,4,11,39,20,19,15:30,Luleå Hockey
21.0,Juhani TyrväinenJ Tyrväinen,F,36,11,19,30,76,2,5,49,37,24,30,17,13,19:10,Luleå Hockey
18.0,Sami LepistöS Lepistö,D,39,4,25,29,24,1,1,82,12,33,26,21,5,23:09,Luleå Hockey
24.0,Brendan ShinniminB Shinnimin,F,52,14,13,27,36,3,7,101,35,14,32,25,7,17:01,Luleå Hockey
71.0,Linus FröbergL Fröberg,F,52,9,17,26,14,5,2,72,5,18,30,26,4,18:04,Luleå Hockey
29.0,Erik GustafssonE Gustafsson,D,48,3,23,26,24,1,1,108,11,54,43,30,13,23:35,Luleå Hockey
17.0,Isac BrännströmI Brännström,F,52,13,11,24,6,2,1,82,15,10,38,22,16,16:12,Luleå Hockey
19.0,Konstantin KomarekK Komarek,F,38,9,14,23,12,0,3,64,13,13,20,24,-4,14:28,Luleå Hockey
60.0,Julius HonkaJ Honka,D,46,10,11,21,22,3,2,152,22,38,29,31,-2,19:34,Luleå Hockey
32.0,Oscar EngsundO Engsund,D,49,9,12,21,45,3,0,87,100,60,48,37,11,19:42,Luleå Hockey
20.0,Jack ConnollyJ Connolly,F,35,10,7,17,16,1,3,44,3,20,17,18,-1,16:53,Luleå Hockey
39.0,Pontus SjälinP Själin,D,42,5,10,15,16,1,0,43,15,32,34,14,20,15:14,Luleå Hockey
44.0,Jonathan AnderssonJ Andersson,D,42,3,10,13,8,1,0,44,14,22,27,14,13,16:12,Luleå Hockey
88.0,Joonas RaskJ Rask,F,47,4,8,12,6,0,3,48,26,13,15,20,-5,14:02,Luleå Hockey
14.0,*Jonas Berglund*J Berglund,F,51,4,6,10,4,1,0,34,13,18,21,14,7,12:53,Luleå Hockey
15.0,Carl MattssonC Mattsson,F,50,4,5,9,6,0,0,29,26,5,16,14,2,9:30,Luleå Hockey
26.0,Radek MuzikR Muzik,F,48,3,5,8,10,0,0,29,13,6,12,9,3,6:21,Luleå Hockey
22.0,*Vilmos Gallo*V Gallo,F,16,2,3,5,6,0,0,19,5,4,7,4,3,11:31,Luleå Hockey
50.0,Daniel SondellD Sondell,D,28,1,2,3,14,0,0,27,5,25,12,11,1,14:25,Luleå Hockey
59.0,Kim JohanssonK Johansson,D,29,1,2,3,4,0,0,18,5,10,6,10,-4,7:15,Luleå Hockey
23.0,Olli NikupeteriO Nikupeteri,F,33,1,2,3,2,0,0,20,7,7,6,10,-4,7:30,Luleå Hockey
55.0,Filip PyrochtaF Pyrochta,D,13,1,1,2,2,0,0,10,2,0,4,6,-2,11:06,Luleå Hockey
10.0,Einar EmanuelssonE Emanuelsson,F,49,1,1,2,2,0,0,40,7,6,12,14,-2,9:30,Luleå Hockey
2.0,Fredrik StyrmanF Styrman,D,8,0,1,1,2,0,0,8,0,4,1,0,1,10:38,Luleå Hockey
55.0,*Edward Björk*E Björk,D,1,0,0,0,0,0,0,0,0,0,0,0,0,0:00,Luleå Hockey
,*Lucas Ramberg*L Ramberg,D,1,0,0,0,0,0,0,0,0,0,0,0,0,0:00,Luleå Hockey
8.0,*Simon Lindblom*S Lindblom,D,1,0,0,0,0,0,0,0,0,0,0,0,0,0:00,Luleå Hockey
8.0,*Dans Locmelis*D Locmelis,F,2,0,0,0,0,0,0,1,0,0,0,0,0,1:42,Luleå Hockey
25.0,*Andreas Nilsson*A Nilsson,F,14,0,0,0,2,0,0,1,0,0,0,2,-2,2:16,Luleå Hockey
22.0,Jonathan JohnsonJ Johnson,F,51,14,38,52,16,2,2,82,4,17,40,30,10,16:41,Skellefteå AIK
94.0,Linus KarlssonL Karlsson,F,52,26,20,46,18,6,13,179,9,19,41,31,10,16:29,Skellefteå AIK
64.0,Jonathan PudasJ Pudas,D,42,7,37,44,32,0,1,67,11,70,39,28,11,23:58,Skellefteå AIK
96.0,Rickard HuggR Hugg,F,52,17,23,40,0,5,6,115,8,22,36,25,11,16:57,Skellefteå AIK
10.0,Joakim LindströmJ Lindström,F,52,11,26,37,16,2,5,153,7,9,30,25,5,16:31,Skellefteå AIK
45.0,Oscar MöllerO Möller,F,49,16,18,34,18,6,1,118,13,26,43,19,24,17:03,Skellefteå AIK
16.0,Linus LindströmL Lindström,F,51,14,13,27,22,3,1,77,24,27,35,15,20,15:40,Skellefteå AIK
58.0,Oskar NilssonO Nilsson,D,48,5,16,21,36,1,2,61,24,20,44,25,19,19:53,Skellefteå AIK
15.0,Melker KarlssonM Karlsson,F,50,11,9,20,20,1,2,56,34,53,28,26,2,16:58,Skellefteå AIK
88.0,Jayce HawrylukJ Hawryluk,F,39,8,11,19,26,2,4,56,41,9,18,22,-4,15:15,Skellefteå AIK
3.0,Michael KaplaM Kapla,D,52,1,18,19,20,1,1,56,11,34,43,26,17,19:00,Skellefteå AIK
2.0,Adam WilsbyA Wilsby,D,51,4,13,17,28,0,0,61,20,14,46,22,24,17:17,Skellefteå AIK
34.0,Tom KühnhacklT Kühnhackl,F,46,3,10,13,6,0,0,56,8,17,28,15,13,13:19,Skellefteå AIK
13.0,Stefan LoiblS Loibl,F,42,4,6,10,6,0,1,52,14,10,18,14,4,13:37,Skellefteå AIK
29.0,Albin SundsvikA Sundsvik,F,47,5,4,9,16,1,0,54,22,15,18,12,6,12:40,Skellefteå AIK
23.0,Adam MascherinA Mascherin,F,15,7,1,8,27,1,2,35,6,1,10,5,5,14:22,Skellefteå AIK
8.0,Petter GranbergP Granberg,D,50,1,6,7,51,0,0,32,78,51,27,25,2,17:04,Skellefteå AIK
26.0,Simon RobertssonS Robertsson,F,48,5,1,6,20,1,0,29,23,9,9,9,0,6:45,Skellefteå AIK
19.0,Filip RoosF Roos,D,50,1,5,6,8,0,0,53,44,22,26,15,11,15:37,Skellefteå AIK
43.0,Filip SandbergF Sandberg,F,22,3,2,5,8,0,1,19,10,12,6,8,-2,11:19,Skellefteå AIK
6.0,Måns ForsfjällM Forsfjäll,D,45,2,3,5,8,0,0,33,29,15,14,12,2,9:51,Skellefteå AIK
24.0,Elias StenmanE Stenman,F,27,2,2,4,0,0,0,12,2,6,4,7,-3,7:07,Skellefteå AIK
42.0,*Zeb Forsfjäll*Z Forsfjäll,F,1,0,0,0,0,0,0,0,0,0,0,0,0,7:59,Skellefteå AIK
18.0,*Theo Keilin*T Keilin,F,1,0,0,0,0,0,0,0,0,0,0,0,0,0:00,Skellefteå AIK
89.0,*Oscar Eriksson*O Eriksson,D,2,0,0,0,0,0,0,0,0,0,0,0,0,0:43,Skellefteå AIK
9.0,*Oscar Nilsson*O Nilsson,F,4,0,0,0,0,0,0,1,0,0,0,0,0,0:14,Skellefteå AIK
40.0,*Jacob Sundin*J Sundin,F,7,0,0,0,0,0,0,0,0,0,0,0,0,3:42,Skellefteå AIK
44.0,Elias SalomonssonE Salomonsson,D,10,0,0,0,2,0,0,1,3,0,1,2,-1,6:24,Skellefteå AIK
5.0,*Fred Nilsson*F Nilsson,D,11,0,0,0,4,0,0,2,1,0,2,1,1,4:20,Skellefteå AIK
27.0,*Gabriel Säll*G Säll,F,12,0,0,0,2,0,0,2,3,3,4,0,4,4:46,Skellefteå AIK
81.0,Ryan LaschR Lasch,F,52,13,53,66,8,3,6,70,4,13,39,40,-1,20:03,Frölunda HC
43.0,Michael SpacekM Spacek,F,49,10,36,46,33,3,5,69,3,9,30,35,-5,17:09,Frölunda HC
25.0,Elmer SöderblomE Söderblom,F,52,21,12,33,10,8,7,132,28,26,26,36,-10,15:14,Frölunda HC
20.0,Joel LundqvistJ Lundqvist,F,52,9,16,25,28,1,6,66,72,14,27,31,-4,17:19,Frölunda HC
12.0,Max FribergM Friberg,F,41,12,10,22,10,5,0,74,33,36,32,25,7,17:05,Frölunda HC
10.0,*Jens Olsson*J Olsson,D,52,7,14,21,10,0,5,79,23,29,30,30,0,16:49,Frölunda HC
74.0,Andreas BorgmanA Borgman,D,24,7,13,20,47,1,3,68,41,22,21,26,-5,22:50,Frölunda HC
7.0,Simon EdvinssonS Edvinsson,D,44,2,17,19,18,0,0,79,34,54,36,23,13,19:42,Frölunda HC
9.0,Jan MursakJ Mursak,F,47,9,9,18,14,0,1,74,36,34,27,19,8,14:38,Frölunda HC
27.0,*Theodor Niederbach*T Niederbach,F,51,9,7,16,12,3,1,60,7,14,15,16,-1,10:35,Frölunda HC
72.0,Patrik CarlssonP Carlsson,F,46,7,9,16,4,1,2,66,21,21,21,21,0,14:46,Frölunda HC
28.0,Johan SundströmJ Sundström,F,49,6,9,15,16,0,1,77,18,25,20,35,-15,13:46,Frölunda HC
2.0,Christian FolinC Folin,D,47,5,10,15,49,0,0,68,96,69,38,29,9,19:53,Frölunda HC
51.0,Mats Rosseli OlsenM Rosseli Olsen,F,51,4,10,14,37,1,0,68,12,22,27,20,7,14:55,Frölunda HC
16.0,*Stefan Elliott*S Elliott,D,47,5,8,13,10,0,0,111,12,49,27,30,-3,18:06,Frölunda HC
5.0,Filip JohanssonF Johansson,D,47,3,8,11,8,0,0,103,18,32,31,26,5,16:45,Frölunda HC
75.0,Radan LencR Lenc,F,14,6,4,10,6,0,2,24,4,8,13,13,0,15:30,Frölunda HC
31.0,Nicklas LasuN Lasu,F,46,5,5,10,53,0,0,62,74,18,26,13,13,14:43,Frölunda HC
21.0,*Karl Henriksson*K Henriksson,F,40,3,6,9,8,2,0,36,10,19,16,12,4,10:11,Frölunda HC
22.0,Linus NässénL Nässén,F,36,4,2,6,14,1,0,25,22,22,8,11,-3,9:10,Frölunda HC
15.0,Anders GrönlundA Grönlund,D,36,4,1,5,10,1,0,31,14,23,11,15,-4,14:04,Frölunda HC
67.0,Jacob NilssonJ Nilsson,F,5,3,1,4,0,1,2,12,1,9,2,4,-2,15:38,Frölunda HC
8.0,Viktor EkbomV Ekbom,D,26,0,4,4,4,0,0,15,22,37,13,6,7,11:58,Frölunda HC
6.0,*Mattias Norlinder*M Norlinder,D,21,0,2,2,2,0,0,29,10,18,9,16,-7,15:02,Frölunda HC
3.0,*Stefan Milosevic*S Milosevic,D,16,1,0,1,0,0,0,4,2,3,1,3,-2,1:56,Frölunda HC
32.0,*Jacob Olofsson*J Olofsson,F,7,0,1,1,0,0,0,4,2,1,1,6,-5,6:31,Frölunda HC
71.0,*Daniel Torgersson*D Torgersson,F,1,0,0,0,0,0,0,0,1,0,0,0,0,7:19,Frölunda HC
55.0,*Theo Angesved*T Angesved,D,1,0,0,0,0,0,0,0,0,0,0,0,0,0:00,Frölunda HC
16.0,*Hugo Gabrielson*H Gabrielson,D,1,0,0,0,0,0,0,0,0,0,0,0,0,0:00,Frölunda HC
32.0,*Noah Hasa*N Hasa,F,8,0,0,0,0,0,0,2,1,1,0,1,-1,1:53,Frölunda HC
44.0,*Ludwig Persson*L Persson,F,10,0,0,0,2,0,0,3,0,0,0,0,0,2:11,Frölunda HC
46.0,Liam Dower NilssonL Dower Nilsson,F,10,0,0,0,2,0,0,4,9,1,0,0,0,4:31,Frölunda HC
10.0,*Richard Gynge*R Gynge,F,52,23,25,48,6,5,14,180,12,27,34,37,-3,16:59,Växjö Lakers
29.0,*Pontus Holmberg*P Holmberg,F,46,11,30,41,44,2,2,79,13,21,31,26,5,18:18,Växjö Lakers
94.0,Joel PerssonJ Persson,D,50,8,31,39,10,2,2,129,4,42,38,35,3,21:44,Växjö Lakers
87.0,Robert RosénR Rosén,F,39,11,27,38,16,3,2,55,4,22,26,24,2,16:33,Växjö Lakers
31.0,*Olle Lycksell*O Lycksell,F,47,14,20,34,6,4,4,104,4,12,31,33,-2,16:42,Växjö Lakers
37.0,Glenn GustafssonG Gustafsson,F,52,16,11,27,27,2,7,68,66,18,25,26,-1,16:24,Växjö Lakers
22.0,Tobias RiederT Rieder,F,36,11,11,22,4,2,5,63,21,14,26,16,10,15:31,Växjö Lakers
33.0,*Julius Nättinen*J Nättinen,F,33,8,12,20,0,3,3,59,15,5,14,14,0,11:49,Växjö Lakers
27.0,Martin LundbergM Lundberg,F,45,8,8,16,41,0,2,63,44,28,24,15,9,15:01,Växjö Lakers
7.0,Hardy Häman AktellH Häman Aktell,D,50,5,11,16,47,0,0,77,24,43,39,33,6,20:13,Växjö Lakers
26.0,Joel KellmanJ Kellman,F,25,6,9,15,29,3,1,47,9,16,19,9,10,16:33,Växjö Lakers
91.0,*Andrew Calof*A Calof,F,34,5,8,13,6,0,0,53,7,9,15,14,1,13:31,Växjö Lakers
8.0,Ludvig ClaessonL Claesson,D,44,5,8,13,10,0,0,42,18,35,27,28,-1,17:38,Växjö Lakers
17.0,*Emil Forslund*E Forslund,F,52,8,4,12,4,0,0,78,21,33,18,26,-8,14:12,Växjö Lakers
60.0,Erik JosefssonE Josefsson,F,51,3,7,10,18,0,0,42,8,37,22,38,-16,15:35,Växjö Lakers
28.0,Hugo GustafssonH Gustafsson,F,40,2,6,8,4,1,0,26,7,5,11,12,-1,10:54,Växjö Lakers
55.0,Miika KoivistoM Koivisto,D,27,1,7,8,12,0,0,33,9,19,16,19,-3,20:58,Växjö Lakers
41.0,Ludvig NilssonL Nilsson,F,50,2,5,7,35,1,0,45,27,23,16,24,-8,11:43,Växjö Lakers
44.0,*Peter Andersson*P Andersson,D,36,2,3,5,45,0,0,29,26,29,14,9,5,14:23,Växjö Lakers
63.0,*Michael Krutil*M Krutil,D,21,0,5,5,4,0,0,11,8,10,14,15,-1,10:01,Växjö Lakers
2.0,Amil KrupicA Krupic,D,14,1,3,4,7,0,0,5,2,6,9,7,2,15:27,Växjö Lakers
52.0,*Arvid Lundberg*A Lundberg,D,43,1,3,4,16,0,0,64,19,33,28,24,4,20:01,Växjö Lakers
53.0,*Ben Thomas*B Thomas,D,15,2,1,3,6,0,0,21,7,12,10,7,3,20:49,Växjö Lakers
5.0,*Juuso Vainio*J Vainio,D,21,0,3,3,2,0,0,30,13,21,12,17,-5,18:38,Växjö Lakers
29.0,Victor StjernborgV Stjernborg,F,15,0,2,2,29,0,0,11,5,2,4,5,-1,9:58,Växjö Lakers
46.0,*Matteus Söderbom*M Söderbom,D,1,0,0,0,0,0,0,0,0,0,0,0,0,0:37,Växjö Lakers
46.0,*Lukas Käkelä*L Käkelä,F,2,0,0,0,0,0,0,0,0,0,0,1,-1,2:28,Växjö Lakers
92.0,*Hugo Pettersson*H Pettersson,F,4,0,0,0,0,0,0,0,1,0,0,0,0,1:01,Växjö Lakers
46.0,*Linus Lööf*L Lööf,F,5,0,0,0,0,0,0,1,2,3,0,0,0,7:42,Växjö Lakers
2.0,*Viktor Bernhardtz*V Bernhardtz,F,12,0,0,0,0,0,0,2,1,0,0,2,-2,2:58,Växjö Lakers
32.0,*Oscar Hagman*O Hagman,F,17,0,0,0,4,0,0,6,14,8,1,4,-3,6:48,Växjö Lakers
6.0,*Theodor Johnsson*T Johnsson,D,18,0,0,0,2,0,0,5,7,4,2,7,-5,7:30,Växjö Lakers
11.0,Joakim NygårdJ Nygård,F,52,16,25,41,30,4,4,108,14,19,46,34,12,18:17,Färjestad BK
13.0,Daniel VikstenD Viksten,F,51,18,21,39,2,5,3,123,11,15,33,35,-2,15:42,Färjestad BK
22.0,Per ÅslundP Åslund,F,49,14,21,35,14,2,1,53,16,29,40,34,6,16:40,Färjestad BK
10.0,Marcus NilssonM Nilsson,F,47,9,22,31,8,1,3,48,3,5,24,21,3,14:42,Färjestad BK
15.0,*Gustav Rydahl*G Rydahl,F,44,15,15,30,53,3,2,82,39,31,35,29,6,17:22,Färjestad BK
71.0,*Jesse Virtanen*J Virtanen,D,50,8,19,27,22,2,1,107,9,56,48,39,9,24:19,Färjestad BK
59.0,Linus JohanssonL Johansson,F,43,13,13,26,30,2,3,70,31,30,31,30,1,18:04,Färjestad BK
33.0,*Albert Johansson*A Johansson,D,52,5,20,25,24,0,3,95,26,37,32,38,-6,18:40,Färjestad BK
14.0,Victor EjdsellV Ejdsell,F,48,8,9,17,45,3,2,117,38,18,22,30,-8,15:47,Färjestad BK
34.0,Michael LindqvistM Lindqvist,F,26,9,7,16,10,0,2,70,7,8,15,14,1,15:38,Färjestad BK
95.0,*Jacob de la Rose*J de la Rose,F,47,6,10,16,26,0,0,68,82,33,33,30,3,17:57,Färjestad BK
26.0,Joel NyströmJ Nyström,D,46,5,11,16,4,1,2,49,9,32,22,32,-10,15:32,Färjestad BK
6.0,Mikael WikstrandM Wikstrand,D,48,3,13,16,20,1,0,61,17,68,34,34,0,20:42,Färjestad BK
28.0,Mattias GöranssonM Göransson,D,48,2,10,12,18,0,0,42,4,37,40,30,10,17:45,Färjestad BK
25.0,Martin JohanssonM Johansson,F,36,5,4,9,0,1,0,35,10,18,10,15,-5,11:55,Färjestad BK
81.0,Theodor LennströmT Lennström,D,11,3,5,8,8,1,0,27,17,10,11,9,2,21:49,Färjestad BK
4.0,Oscar LawnerO Lawner,F,45,4,3,7,29,0,0,61,10,12,16,20,-4,10:29,Färjestad BK
67.0,Pontus WiderströmP Widerström,F,52,2,5,7,43,1,0,36,65,33,13,22,-9,11:23,Färjestad BK
29.0,*Lucas Forsell*L Forsell,F,30,4,2,6,0,1,2,17,6,9,9,9,0,6:36,Färjestad BK
37.0,*Adam Ginning*A Ginning,D,51,1,4,5,42,0,0,35,49,34,33,33,0,17:49,Färjestad BK
31.0,Carl JakobssonC Jakobsson,F,38,2,2,4,6,0,0,37,5,19,9,15,-6,11:05,Färjestad BK
79.0,Patrik LundhP Lundh,F,20,1,2,3,2,0,1,26,7,6,5,9,-4,12:58,Färjestad BK
3.0,Jens WestinJ Westin,D,8,0,1,1,0,0,0,6,1,10,5,4,1,12:35,Färjestad BK
18.0,*Martin Skärberg*M Skärberg,D,2,0,0,0,0,0,0,0,0,0,0,0,0,0:00,Färjestad BK
23.0,*Alexander Artursson*A Artursson,F,2,0,0,0,0,0,0,0,0,0,0,0,0,1:09,Färjestad BK
16.0,*Hugo Hell*H Hell,D,2,0,0,0,0,0,0,0,0,0,0,0,0,0:00,Färjestad BK
36.0,*Noah Andersson*N Andersson,F,4,0,0,0,0,0,0,0,0,0,0,0,0,2:42,Färjestad BK
12.0,*Gustav Berglund*G Berglund,D,7,0,0,0,0,0,0,1,3,2,1,2,-1,5:10,Färjestad BK
20.0,*Martin Johnsen*M Johnsen,F,11,0,0,0,2,0,0,2,2,1,2,1,1,2:27,Färjestad BK
24.0,*Sigge Grunditz*S Grunditz,F,12,0,0,0,0,0,0,3,2,1,0,2,-2,3:51,Färjestad BK
8.0,Anton BerglundA Berglund,D,34,0,0,0,0,0,0,1,2,7,3,7,-4,3:23,Färjestad BK
96.0,Robin KovacsR Kovacs,F,52,21,20,41,26,4,4,121,15,26,42,18,24,17:11,Örebro Hockey
18.0,Rodrigo AbolsR Abols,F,47,14,20,34,6,5,3,115,32,31,42,16,26,17:37,Örebro Hockey
74.0,Nick EbertN Ebert,D,49,9,23,32,32,4,3,131,15,25,46,23,23,19:17,Örebro Hockey
21.0,Linus ÖbergL Öberg,F,52,17,9,26,18,3,3,99,27,36,39,22,17,15:29,Örebro Hockey
24.0,Jani LajunenJ Lajunen,F,50,9,16,25,26,0,2,52,45,29,26,23,3,16:20,Örebro Hockey
36.0,Emil LarssonE Larsson,F,52,12,10,22,10,2,3,90,51,34,28,26,2,16:25,Örebro Hockey
51.0,Kristian NäkyväK Näkyvä,D,36,6,12,18,18,0,0,83,12,29,27,26,1,21:54,Örebro Hockey
33.0,Christopher MastomäkiC Mastomäki,F,52,6,12,18,16,1,0,56,19,25,27,22,5,13:44,Örebro Hockey
73.0,Oliver EklindO Eklind,F,52,8,8,16,24,2,0,68,33,33,28,22,6,14:14,Örebro Hockey
40.0,Elias EkströmE Ekström,F,52,5,11,16,6,2,1,45,12,30,21,22,-1,12:53,Örebro Hockey
62.0,Robert LeinoR Leino,F,50,3,13,16,26,0,1,66,12,25,29,25,4,16:02,Örebro Hockey
23.0,Petr ZamorskyP Zamorsky,D,49,3,10,13,24,0,0,64,11,22,34,19,15,17:14,Örebro Hockey
9.0,Nicholas HalloranN Halloran,F,20,6,6,12,10,0,1,37,5,9,9,8,1,13:57,Örebro Hockey
5.0,Gustav BackströmG Backström,D,52,4,8,12,4,1,0,80,20,63,44,30,14,21:08,Örebro Hockey
20.0,*Miikka Salomäki*M Salomäki,F,34,3,8,11,20,0,0,38,33,14,14,11,3,13:25,Örebro Hockey
39.0,Joel MustonenJ Mustonen,F,42,5,4,9,6,1,0,39,11,18,19,10,9,12:45,Örebro Hockey
10.0,Leo CarlssonL Carlsson,F,35,3,6,9,4,1,0,21,9,12,15,14,1,11:14,Örebro Hockey
7.0,Marcus HardegårdM Hardegård,D,50,0,8,8,16,0,0,50,20,40,24,17,7,15:50,Örebro Hockey
34.0,Libor SulakL Sulak,D,11,3,4,7,8,0,1,29,2,18,10,12,-2,20:16,Örebro Hockey
16.0,Daniel AudetteD Audette,F,11,2,4,6,4,0,0,18,2,7,5,7,-2,16:59,Örebro Hockey
2.0,Rasmus RissanenR Rissanen,D,23,2,4,6,16,1,0,31,28,21,17,12,5,21:41,Örebro Hockey
71.0,Juuso PuustinenJ Puustinen,F,25,3,1,4,0,1,1,16,1,5,2,5,-3,6:21,Örebro Hockey
77.0,Kristaps ZileK Zile,D,12,0,4,4,2,0,0,8,13,15,8,5,3,17:42,Örebro Hockey
27.0,Simon ForsmarkS Forsmark,D,41,0,3,3,2,0,0,24,6,21,11,14,-3,9:55,Örebro Hockey
6.0,*Stefan Warg*S Warg,D,14,0,1,1,2,0,0,9,4,11,3,5,-2,13:46,Örebro Hockey
25.0,Elias PetterssonE Pettersson,D,17,0,1,1,0,0,0,5,6,0,5,1,4,6:23,Örebro Hockey
29.0,*Milton Oscarson*M Oscarson,F,24,0,1,1,0,0,0,10,7,6,2,4,-2,8:14,Örebro Hockey
34.0,*Gustav Stjernberg*G Stjernberg,D,1,0,0,0,0,0,0,0,0,0,1,1,0,2:21,Örebro Hockey
9.0,*Marcus Limpar Lantz*M Limpar Lantz,F,2,0,0,0,0,0,0,0,0,0,0,0,0,0:24,Örebro Hockey
12.0,*Gustav Karlsson*G Karlsson,F,2,0,0,0,0,0,0,0,0,2,0,0,0,0:44,Örebro Hockey
4.0,*Johan Persson*J Persson,D,2,0,0,0,0,0,0,0,0,0,0,0,0,0:06,Örebro Hockey
4.0,*Niklas Nilsson*N Nilsson,D,5,0,0,0,0,0,0,1,1,1,2,0,2,4:12,Örebro Hockey
4.0,*Adam Hofbauer*A Hofbauer,F,5,0,0,0,0,0,0,0,0,0,0,0,0,1:11,Örebro Hockey
41.0,*Filip Barklund*F Barklund,F,10,0,0,0,2,0,0,4,1,1,0,0,0,2:15,Örebro Hockey
15.0,*Max Veronneau*M Veronneau,F,51,34,26,60,14,7,5,183,3,21,55,37,18,20:14,Leksands IF
25.0,Carter CamperC Camper,F,50,11,37,48,28,3,3,123,5,15,46,39,7,19:01,Leksands IF
23.0,Mikael RuohomaaM Ruohomaa,F,48,12,28,40,14,0,8,97,3,23,27,42,-15,21:05,Leksands IF
9.0,Patrik ZackrissonP Zackrisson,F,42,11,25,36,8,0,2,71,21,23,44,23,21,19:01,Leksands IF
8.0,Matt CaitoM Caito,D,49,3,21,24,28,1,3,121,11,46,53,46,7,22:52,Leksands IF
28.0,Justin KloosJ Kloos,F,45,9,13,22,18,4,1,88,18,37,20,27,-7,19:34,Leksands IF
44.0,Carter AshtonC Ashton,F,52,7,15,22,18,1,4,100,17,9,20,26,-6,14:11,Leksands IF
5.0,Calle SjälinC Själin,D,46,6,16,22,8,2,0,124,19,50,38,44,-6,20:30,Leksands IF
29.0,*Emil Heineman*E Heineman,F,38,11,5,16,20,1,1,58,28,12,16,24,-8,11:34,Leksands IF
26.0,Patrik NorénP Norén,D,45,5,10,15,38,2,0,83,43,42,39,31,8,19:18,Leksands IF
14.0,Oskar LangO Lang,F,50,9,5,14,4,2,3,85,2,39,19,34,-15,14:30,Leksands IF
11.0,Martin KarlssonM Karlsson,F,52,8,6,14,14,0,1,77,52,42,19,30,-11,12:43,Leksands IF
66.0,Nils ÅmanN Åman,F,51,6,8,14,8,1,0,50,18,16,24,20,4,13:41,Leksands IF
22.0,Tobias EkbergT Ekberg,D,38,0,12,12,22,0,0,45,19,33,27,22,5,16:45,Leksands IF
6.0,Alexander LundqvistA Lundqvist,D,49,1,8,9,6,0,0,57,14,37,19,26,-7,14:38,Leksands IF
13.0,Jon KnutsJ Knuts,F,40,2,6,8,12,0,0,42,52,41,21,22,-1,13:20,Leksands IF
55.0,Jonas AhnelövJ Ahnelöv,D,38,1,7,8,15,0,0,30,45,55,17,21,-4,16:36,Leksands IF
17.0,*Linus Andersson*L Andersson,F,25,4,2,6,8,0,1,33,9,6,8,10,-2,10:03,Leksands IF
27.0,Marek HrivíkM Hrivík,F,11,3,3,6,0,0,1,24,2,4,5,10,-5,20:34,Leksands IF
13.0,*Isak Rosén*I Rosén,F,28,2,2,4,0,0,0,23,0,5,8,6,2,7:53,Leksands IF
53.0,*Ben Thomas*B Thomas,D,32,2,1,3,16,0,0,29,13,21,17,14,3,13:42,Leksands IF
20.0,Lian BichselL Bichsel,D,29,1,2,3,16,0,0,17,28,14,8,14,-6,11:48,Leksands IF
17.0,*Erik Hedlund*E Hedlund,F,6,0,1,1,0,0,0,1,0,1,1,2,-1,3:34,Leksands IF
58.0,*Fredrik Forsberg*F Forsberg,F,22,0,1,1,4,0,0,13,8,4,2,4,-2,4:28,Leksands IF
32.0,Jesper KandergårdJ Kandergård,F,23,0,1,1,25,0,0,7,3,6,4,11,-7,6:06,Leksands IF
12.0,*Arvid Lundberg Brobäck*A Lundberg Brobäck,F,1,0,0,0,0,0,0,0,0,0,0,0,0,0:00,Leksands IF
17.0,*Wille Bärehag*W Bärehag,F,1,0,0,0,0,0,0,1,0,0,0,0,0,2:55,Leksands IF
90.0,*Daniel Ljunggren*D Ljunggren,F,2,0,0,0,0,0,0,1,0,0,0,2,-2,12:30,Leksands IF
16.0,*Lucas Lagerberg*L Lagerberg,D,3,0,0,0,0,0,0,0,0,0,0,0,0,0:22,Leksands IF
7.0,*Anton Johansson*A Johansson,D,4,0,0,0,0,0,0,1,1,0,0,1,-1,3:20,Leksands IF
4.0,*Kasper Magnussen*K Magnussen,F,6,0,0,0,0,0,0,2,5,0,0,1,-1,1:18,Leksands IF
16.0,*Arvid Eljas*A Eljas,F,8,0,0,0,2,0,0,4,1,0,0,2,-2,3:35,Leksands IF
16.0,*David Rosander*D Rosander,D,9,0,0,0,0,0,0,3,2,2,1,2,-1,7:54,Leksands IF
3.0,*August Berg*A Berg,D,19,0,0,0,4,0,0,14,8,7,3,8,-5,9:43,Leksands IF
89.0,Patrik KarlkvistP Karlkvist,F,49,26,26,52,2,5,7,93,3,22,42,36,6,16:59,IK Oskarshamn
8.0,Fredrik OlofssonF Olofsson,F,49,15,27,42,6,4,6,127,10,24,41,39,2,18:53,IK Oskarshamn
29.0,*Kim Rosdahl*K Rosdahl,F,52,18,20,38,24,0,4,90,45,31,46,38,8,18:27,IK Oskarshamn
80.0,Tomas ZohornaT Zohorna,F,51,12,19,31,33,2,5,76,23,3,24,31,-7,17:35,IK Oskarshamn
20.0,Hynek ZohornaH Zohorna,F,48,10,19,29,16,1,5,66,16,8,21,24,-3,16:50,IK Oskarshamn
93.0,Cameron BraceC Brace,F,48,9,15,24,62,1,4,73,20,10,21,37,-16,14:38,IK Oskarshamn
55.0,David QuennevilleD Quenneville,D,51,4,19,23,67,1,1,117,31,25,21,26,-5,18:23,IK Oskarshamn
22.0,John DahlströmJ Dahlström,F,52,5,14,19,0,1,2,81,8,17,24,20,4,14:32,IK Oskarshamn
21.0,*Brian Cooper*B Cooper,D,50,2,13,15,65,0,0,91,70,43,42,40,2,22:30,IK Oskarshamn
17.0,Jonas EngströmJ Engström,F,52,8,6,14,8,2,0,74,10,22,24,20,4,15:13,IK Oskarshamn
26.0,Lukas PilöL Pilö,D,52,3,11,14,18,0,0,68,23,25,38,32,6,17:10,IK Oskarshamn
41.0,Johan JohnssonJ Johnsson,F,45,4,8,12,10,2,0,51,14,15,22,20,2,16:32,IK Oskarshamn
56.0,Robin NorellR Norell,D,50,3,9,12,34,1,0,40,36,34,25,37,-12,16:30,IK Oskarshamn
34.0,Philip SamuelssonP Samuelsson,D,52,2,8,10,32,0,0,63,20,47,34,39,-5,19:05,IK Oskarshamn
85.0,Daniel Muzito-BagendaD Muzito-Bagenda,F,46,4,3,7,18,0,0,37,21,14,14,22,-8,10:51,IK Oskarshamn
76.0,*Emil Martinsen Lilleberg*E Martinsen Lilleberg,D,47,0,7,7,16,0,0,37,52,27,18,22,-4,11:40,IK Oskarshamn
11.0,Joakim ThelinJ Thelin,F,49,5,1,6,6,1,0,48,13,15,8,16,-8,9:16,IK Oskarshamn
3.0,William Worge KreüW Worge Kreü,D,47,1,5,6,31,1,0,22,57,32,20,16,4,13:33,IK Oskarshamn
14.0,Mikkel Øby-OlsenM Øby-Olsen,F,35,3,1,4,0,0,0,13,2,8,6,5,1,5:53,IK Oskarshamn
9.0,*Hampus Plato*H Plato,F,34,2,2,4,6,0,0,18,6,3,8,7,1,6:11,IK Oskarshamn
10.0,*Dale Weise*D Weise,F,17,2,1,3,10,1,0,19,17,2,4,11,-7,11:42,IK Oskarshamn
25.0,Johannes SalmonssonJ Salmonsson,F,34,2,0,2,8,0,0,12,14,13,6,17,-11,9:44,IK Oskarshamn
98.0,*Oliver Joakim Larsen*O Larsen,D,1,0,0,0,0,0,0,0,0,0,0,0,0,1:32,IK Oskarshamn
44.0,*Nils Bolin*N Bolin,F,1,0,0,0,0,0,0,0,0,0,0,0,0,0:32,IK Oskarshamn
44.0,*Douglas Andersson*D Andersson,F,4,0,0,0,0,0,0,1,0,1,0,1,-1,4:56,IK Oskarshamn
2.0,*Hugo Jonasson*H Jonasson,D,5,0,0,0,0,0,0,0,0,0,0,0,0,1:01,IK Oskarshamn
6.0,*Charlie Björklund*C Björklund,F,5,0,0,0,0,0,0,0,0,1,0,0,0,0:56,IK Oskarshamn
27.0,Johan AlmJ Alm,D,8,0,0,0,8,0,0,0,5,2,2,2,0,9:42,IK Oskarshamn
20.0,Oula PalveO Palve,F,50,11,24,35,18,1,4,103,21,23,28,31,-3,17:44,Brynäs IF
18.0,Anton RödinA Rödin,F,52,19,15,34,22,3,4,135,13,17,34,36,-2,18:27,Brynäs IF
41.0,Greg ScottG Scott,F,52,9,23,32,8,4,3,107,45,42,35,37,-2,18:52,Brynäs IF
10.0,*Noel Gunler*N Gunler,F,52,13,10,23,36,3,2,111,4,8,23,30,-7,13:53,Brynäs IF
5.0,*Chay Genoway*C Genoway,D,51,5,16,21,14,1,1,81,2,49,28,43,-15,19:22,Brynäs IF
88.0,Dmytro TimashovD Timashov,F,29,8,10,18,41,1,2,58,24,5,17,14,3,17:39,Brynäs IF
40.0,Tomi SallinenT Sallinen,F,48,8,10,18,12,1,4,75,11,16,18,39,-21,17:02,Brynäs IF
36.0,Linus ÖlundL Ölund,F,51,11,6,17,6,4,0,64,37,13,25,30,-5,13:52,Brynäs IF
95.0,Nick OlesenN Olesen,F,49,8,9,17,6,2,2,91,16,14,22,29,-7,15:15,Brynäs IF
44.0,*Nicklas Danielsson*N Danielsson,F,51,6,11,17,16,1,2,54,7,20,21,18,3,13:32,Brynäs IF
34.0,Oscar EklindO Eklind,F,49,8,8,16,18,2,1,73,31,23,24,21,3,14:06,Brynäs IF
62.0,Tom HedbergT Hedberg,D,50,4,12,16,6,0,0,44,7,48,27,22,5,16:35,Brynäs IF
7.0,Marcus BjörkM Björk,D,52,3,12,15,26,0,0,88,34,52,35,36,-1,18:56,Brynäs IF
15.0,Simon BertilssonS Bertilsson,D,49,2,9,11,38,0,0,70,79,53,31,33,-2,19:48,Brynäs IF
24.0,Emil MolinE Molin,F,28,2,7,9,0,0,0,23,8,5,13,10,3,13:16,Brynäs IF
22.0,Adam PetterssonA Pettersson,F,46,4,4,8,12,0,0,41,18,14,12,19,-7,11:57,Brynäs IF
29.0,Oscar BirgerssonO Birgersson,F,44,1,5,6,2,0,0,21,25,8,10,6,4,8:45,Brynäs IF
63.0,Julius BergmanJ Bergman,D,43,3,2,5,8,0,0,49,39,27,22,22,0,13:11,Brynäs IF
28.0,Oskar KvistO Kvist,F,39,1,4,5,4,0,0,23,12,11,10,12,-2,7:42,Brynäs IF
28.0,*John Nyberg*J Nyberg,D,11,0,3,3,6,0,0,8,10,5,8,3,5,13:31,Brynäs IF
9.0,*Anton Mylläri*A Mylläri,D,51,0,3,3,43,0,0,32,13,50,21,24,-3,14:05,Brynäs IF
22.0,*Daniel Mannberg*D Mannberg,F,10,0,2,2,4,0,0,5,2,7,3,6,-3,11:26,Brynäs IF
38.0,*Oskars Cibulskis*O Cibulskis,D,11,0,2,2,0,0,0,17,3,3,4,3,1,13:12,Brynäs IF
73.0,*Theo Lindstein*T Lindstein,D,12,0,1,1,0,0,0,8,2,2,2,4,-2,9:21,Brynäs IF
90.0,*Linus Hemström*L Hemström,F,1,0,0,0,0,0,0,0,0,0,0,0,0,1:25,Brynäs IF
39.0,*Adam Dahlström*A Dahlström,F,1,0,0,0,0,0,0,0,0,0,0,0,0,0:53,Brynäs IF
14.0,*Tom Wandell*T Wandell,F,1,0,0,0,2,0,0,0,1,0,0,0,0,7:55,Brynäs IF
19.0,*Joel Holmli*J Holmli,F,2,0,0,0,0,0,0,0,0,0,0,0,0,0:00,Brynäs IF
89.0,*Alexander Ljungkrantz*A Ljungkrantz,F,5,0,0,0,0,0,0,3,0,0,0,2,-2,8:29,Brynäs IF
2.0,*Kristofer Berglund*K Berglund,D,48,0,0,0,8,0,0,24,15,21,11,17,-6,11:59,Brynäs IF
61.0,Markus LjunghM Ljungh,F,52,15,29,44,14,3,3,93,15,13,35,28,7,19:08,Linköping HC
41.0,Broc LittleB Little,F,51,15,14,29,40,4,4,129,6,14,33,28,5,18:28,Linköping HC
19.0,Patrick RussellP Russell,F,42,18,10,28,14,2,10,107,28,18,24,29,-5,18:16,Linköping HC
44.0,Jonas JunlandJ Junland,D,41,2,26,28,19,1,1,87,13,39,29,29,0,21:08,Linköping HC
11.0,Henrik TörnqvistH Törnqvist,F,52,12,13,25,8,2,4,102,23,32,24,35,-11,17:50,Linköping HC
71.0,*Robert Lantosi*R Lantosi,F,42,10,12,22,31,5,0,76,14,9,22,18,4,15:13,Linköping HC
37.0,Jesper PetterssonJ Pettersson,D,50,5,16,21,77,0,2,66,27,30,32,43,-11,22:02,Linköping HC
21.0,Christoffer EhnC Ehn,F,50,9,9,18,10,1,0,69,37,22,23,27,-4,18:20,Linköping HC
18.0,Alexander JohanssonA Johansson,F,52,4,10,14,22,1,1,64,26,33,16,18,-2,13:38,Linköping HC
49.0,Ben MaxwellB Maxwell,F,38,6,6,12,8,2,1,46,9,18,18,17,1,15:18,Linköping HC
22.0,Vilmos GalloV Gallo,F,27,5,4,9,12,1,0,60,21,11,19,14,5,14:20,Linköping HC
28.0,John NybergJ Nyberg,D,40,2,7,9,16,0,0,44,20,32,26,17,9,16:35,Linköping HC
53.0,*Eddie Larsson*E Larsson,D,50,1,7,8,30,0,0,35,61,54,27,25,2,19:38,Linköping HC
14.0,Arvid CostmarA Costmar,F,48,3,4,7,16,0,2,45,35,16,11,16,-5,11:19,Linköping HC
55.0,Max LindrothM Lindroth,D,52,4,1,5,59,0,0,48,23,39,26,26,0,15:39,Linköping HC
84.0,*Jimmy Andersson*J Andersson,F,35,3,2,5,6,1,0,26,13,6,9,9,0,8:39,Linköping HC
6.0,Craig SchiraC Schira,D,40,1,3,4,16,0,0,41,66,51,16,20,-4,17:43,Linköping HC
29.0,*Daniel Ljungman*D Ljungman,F,27,2,1,3,4,0,0,22,6,2,5,12,-7,9:40,Linköping HC
24.0,Elliot EkmarkE Ekmark,F,44,2,1,3,12,0,0,17,10,10,4,11,-7,7:19,Linköping HC
32.0,*Markus Modigs*M Modigs,F,15,0,3,3,0,0,0,12,3,4,5,8,-3,11:00,Linköping HC
25.0,*Filip Bystedt*F Bystedt,F,15,1,1,2,0,1,0,7,0,4,3,5,-2,8:25,Linköping HC
29.0,*Georg Weigelt*G Weigelt,F,40,1,1,2,0,0,0,32,12,12,9,8,1,9:40,Linköping HC
5.0,*Mattias Bäckman*M Bäckman,D,3,0,1,1,6,0,0,1,0,2,1,4,-3,16:59,Linköping HC
5.0,*Roberts Mamcics*R Mamcics,D,12,0,1,1,6,0,0,11,9,16,1,4,-3,14:22,Linköping HC
17.0,*Brian Gibbons*B Gibbons,F,17,0,1,1,8,0,0,22,15,9,4,13,-9,15:29,Linköping HC
36.0,*Linus Cronholm*L Cronholm,D,34,0,1,1,16,0,0,20,30,17,9,15,-6,10:57,Linköping HC
8.0,*Albert Lyckåsen*A Lyckåsen,D,1,0,0,0,0,0,0,0,0,0,0,0,0,0:14,Linköping HC
36.0,*Olle Norberg*O Norberg,D,1,0,0,0,0,0,0,0,0,0,0,0,0,6:45,Linköping HC
8.0,*Martin Schreiber*M Schreiber,D,2,0,0,0,0,0,0,0,0,0,0,0,0,0:00,Linköping HC
27.0,*William Magnusson*W Magnusson,F,5,0,0,0,0,0,0,1,1,0,0,0,0,1:54,Linköping HC
26.0,*Fabian Wagner*F Wagner,F,8,0,0,0,0,0,0,1,0,1,0,2,-2,4:04,Linköping HC
20.0,*Nikola Pasic*N Pasic,F,13,0,0,0,0,0,0,6,1,1,1,3,-2,8:06,Linköping HC
8.0,*Jonathan Myrenberg*J Myrenberg,D,15,0,0,0,2,0,0,8,1,5,5,4,1,9:35,Linköping HC
4.0,*Mattias Hävelid*M Hävelid,D,23,0,0,0,0,0,0,18,10,9,3,7,-4,9:14,Linköping HC
34.0,Carl SöderbergC Söderberg,F,52,22,19,41,47,3,6,157,33,15,37,36,1,20:11,Malmö Redhawks
47.0,Joakim RyanJ Ryan,D,52,9,22,31,14,1,6,112,13,52,33,40,-7,23:54,Malmö Redhawks
17.0,Pathrik WesterholmP Westerholm,F,49,5,25,30,12,2,1,89,10,8,24,31,-7,15:56,Malmö Redhawks
27.0,Ponthus WesterholmP Westerholm,F,52,10,18,28,41,2,3,141,15,20,25,35,-10,16:05,Malmö Redhawks
95.0,Carl PerssonC Persson,F,52,11,14,25,10,1,3,87,44,12,30,29,1,14:07,Malmö Redhawks
90.0,Lance BoumaL Bouma,F,51,9,15,24,45,0,3,76,71,26,37,28,9,17:03,Malmö Redhawks
11.0,Markus LauridsenM Lauridsen,D,40,2,17,19,6,0,0,71,19,27,36,28,8,17:36,Malmö Redhawks
18.0,Marcus SylvegårdM Sylvegård,F,44,11,7,18,17,2,2,86,45,10,20,22,-2,14:53,Malmö Redhawks
51.0,Emil SylvegårdE Sylvegård,F,46,9,9,18,55,1,0,72,62,25,26,31,-5,14:40,Malmö Redhawks
63.0,Fredrik HändemarkF Händemark,F,40,6,12,18,8,0,2,73,26,19,21,32,-11,17:13,Malmö Redhawks
73.0,Adam Ollas MattssonA Ollas Mattsson,D,52,3,12,15,16,1,0,119,52,55,42,32,10,21:45,Malmö Redhawks
13.0,Kalle ÖstmanK Östman,F,44,3,10,13,16,0,0,47,7,4,21,23,-2,11:24,Malmö Redhawks
23.0,Christoffer ForsbergC Forsberg,F,52,6,6,12,8,2,0,37,17,21,21,21,0,12:28,Malmö Redhawks
8.0,Johan OlofssonJ Olofsson,F,52,2,10,12,6,2,0,63,15,17,14,21,-7,13:23,Malmö Redhawks
16.0,Matias LassenM Lassen,D,38,1,11,12,6,0,0,31,21,31,27,20,7,17:52,Malmö Redhawks
29.0,Eric EngstrandE Engstrand,F,41,7,3,10,2,1,0,30,29,9,16,16,0,9:51,Malmö Redhawks
22.0,Lars BryggmanL Bryggman,F,41,7,3,10,18,2,1,53,29,17,13,21,-8,11:54,Malmö Redhawks
14.0,Carl-Johan LerbyC Lerby,D,51,3,6,9,24,0,0,59,10,46,33,47,-14,17:37,Malmö Redhawks
56.0,Anton OlssonA Olsson,D,39,2,4,6,6,1,0,39,19,11,13,13,0,12:54,Malmö Redhawks
7.0,Oliver LauridsenO Lauridsen,D,42,3,0,3,41,0,0,24,50,31,13,21,-8,12:32,Malmö Redhawks
91.0,Magnus PääjärviM Pääjärvi,F,17,2,1,3,2,0,1,27,9,4,1,9,-8,14:12,Malmö Redhawks
41.0,*Jaedon Descheneau*J Descheneau,F,10,1,1,2,4,0,0,15,8,4,4,4,0,13:52,Malmö Redhawks
65.0,Alexander MolldénA Molldén,D,31,0,2,2,8,0,0,20,6,9,3,16,-13,9:08,Malmö Redhawks
55.0,*Anton Wahlberg*A Wahlberg,F,1,0,0,0,0,0,0,0,0,0,0,1,-1,0:00,Malmö Redhawks
58.0,*Hugo Wendt*H Wendt,D,1,0,0,0,0,0,0,0,0,0,0,0,0,10:06,Malmö Redhawks
58.0,*Tim Lindfors*T Lindfors,F,1,0,0,0,0,0,0,1,0,0,0,2,-2,5:38,Malmö Redhawks
90.0,*Rikard Olsén*R Olsén,D,2,0,0,0,0,0,0,4,2,1,1,3,-2,17:00,Malmö Redhawks
44.0,*Marcus Broberg*M Broberg,D,2,0,0,0,2,0,0,0,0,1,0,0,0,2:56,Malmö Redhawks
44.0,*Isac Göransson*I Göransson,F,5,0,0,0,0,0,0,0,0,0,0,0,0,0:00,Malmö Redhawks
17.0,*William Von Barnekow*W Von Barnekow,F,27,0,0,0,0,0,0,1,7,5,0,3,-3,3:48,Malmö Redhawks
20.0,*Marcus Sörensen*M Sörensen,F,47,20,24,44,72,2,3,98,29,14,43,40,3,19:37,Djurgården Hockey
21.0,*Filip Cederqvist*F Cederqvist,F,49,14,18,32,10,2,6,114,44,25,32,33,-1,17:57,Djurgården Hockey
24.0,Ludvig RensfeldtL Rensfeldt,F,52,14,17,31,24,1,3,103,18,34,37,36,1,18:33,Djurgården Hockey
49.0,*Rhett Rakhshani*R Rakhshani,F,50,11,15,26,14,3,1,103,9,23,27,39,-12,15:51,Djurgården Hockey
13.0,*Rasmus Bengtsson*R Bengtsson,D,50,5,12,17,12,1,0,116,4,36,36,39,-3,19:51,Djurgården Hockey
17.0,*Marc-André Gragnani*M Gragnani,D,32,4,10,14,6,0,1,55,0,33,28,35,-7,20:12,Djurgården Hockey
72.0,*William Eklund*W Eklund,F,29,1,13,14,4,0,0,40,10,6,17,24,-7,17:42,Djurgården Hockey
46.0,Tim SöderlundT Söderlund,F,21,6,7,13,16,1,3,35,15,2,12,15,-3,15:30,Djurgården Hockey
31.0,*Dick Axelsson*D Axelsson,F,19,5,8,13,28,1,0,30,5,4,10,11,-1,14:03,Djurgården Hockey
82.0,*Paul Carey*P Carey,F,41,4,8,12,12,0,3,43,14,17,15,34,-19,15:10,Djurgården Hockey
29.0,*Sebastian Strandberg*S Strandberg,F,27,3,9,12,2,0,0,29,14,9,15,23,-8,17:12,Djurgården Hockey
88.0,Jonathan LekkerimäkiJ Lekkerimäki,F,26,7,2,9,0,0,3,50,10,2,5,5,0,10:22,Djurgården Hockey
42.0,Ludvig HedströmL Hedström,D,48,2,7,9,6,1,0,24,27,36,22,17,5,12:57,Djurgården Hockey
9.0,*Cameron Schilling*C Schilling,D,22,1,8,9,10,1,0,34,9,35,21,18,3,21:56,Djurgården Hockey
55.0,*Linus Videll*L Videll,F,11,3,5,8,0,0,2,16,6,2,5,8,-3,18:17,Djurgården Hockey
17.0,*Linus Andersson*L Andersson,F,25,5,2,7,28,2,0,48,16,11,10,12,-2,13:46,Djurgården Hockey
86.0,*Éric Gélinas*É Gélinas,D,13,4,2,6,10,0,2,56,15,9,9,9,0,23:00,Djurgården Hockey
33.0,*Filiph Engsund*F Engsund,F,46,3,3,6,16,0,0,36,9,27,14,20,-6,13:24,Djurgården Hockey
96.0,*Matt Lorito*M Lorito,F,14,2,4,6,8,0,0,24,2,4,6,10,-4,12:39,Djurgården Hockey
67.0,*Peter Holland*P Holland,F,15,0,6,6,31,0,0,32,5,4,5,12,-7,15:51,Djurgården Hockey
55.0,*Emile Poirier*E Poirier,F,11,3,2,5,13,0,0,12,5,2,9,9,0,13:38,Djurgården Hockey
43.0,*Tom Nilsson*T Nilsson,D,24,2,3,5,16,1,0,31,29,33,19,23,-4,19:23,Djurgården Hockey
96.0,Emil BerglundE Berglund,F,26,2,3,5,8,0,0,24,22,6,10,12,-2,11:22,Djurgården Hockey
10.0,*Niclas Bergfors*N Bergfors,F,50,2,3,5,8,2,0,88,12,14,11,27,-16,11:38,Djurgården Hockey
4.0,Marcus HögströmM Högström,D,8,2,2,4,2,0,0,13,5,4,5,11,-6,21:12,Djurgården Hockey
8.0,Linus ArnessonL Arnesson,D,43,2,2,4,20,0,0,45,38,28,17,30,-13,20:01,Djurgården Hockey
26.0,*Alex Brännstam*A Brännstam,D,17,0,3,3,2,0,0,7,3,11,6,9,-3,8:39,Djurgården Hockey
6.0,*Josef Ingman*J Ingman,D,26,0,3,3,6,0,0,20,29,9,10,20,-10,11:50,Djurgården Hockey
6.0,*Stefan Warg*S Warg,D,37,0,3,3,14,0,0,34,50,31,14,21,-7,17:31,Djurgården Hockey
58.0,Fredrik ForsbergF Forsberg,F,23,1,1,2,0,1,0,17,11,8,3,4,-1,6:41,Djurgården Hockey
48.0,*Pontus Johansson*P Johansson,D,25,1,1,2,4,0,1,18,5,3,3,15,-12,10:26,Djurgården Hockey
15.0,Liam ÖhgrenL Öhgren,F,25,1,1,2,6,0,0,13,11,5,3,10,-7,6:59,Djurgården Hockey
22.0,*Oscar Bjerselius*O Bjerselius,F,34,0,2,2,4,0,0,20,7,15,5,18,-13,10:58,Djurgården Hockey
53.0,*Adam Engström*A Engström,D,1,0,0,0,0,0,0,0,0,0,0,0,0,0:00,Djurgården Hockey
22.0,*Tobias Ekberg*T Ekberg,D,4,0,0,0,0,0,0,2,4,3,0,6,-6,13:28,Djurgården Hockey
,Calle OdeliusC Odelius,D,7,0,0,0,0,0,0,0,0,1,0,1,-1,4:07,Djurgården Hockey
53.0,Wiktor NilssonW Nilsson,F,8,0,0,0,0,0,0,2,7,3,0,1,-1,7:38,Djurgården Hockey
62.0,*Nils Strandberg Sarén*N Strandberg Sarén,D,9,0,0,0,0,0,0,4,1,1,1,2,-1,4:33,Djurgården Hockey
50.0,Noah ÖstlundN Östlund,F,11,0,0,0,0,0,0,4,1,2,0,2,-2,6:59,Djurgården Hockey
39.0,*Ty Rattie*T Rattie,F,51,21,26,47,32,3,13,203,9,12,32,48,-16,19:01,Timrå IK
78.0,Robin HanzlR Hanzl,F,52,13,27,40,32,3,4,71,43,19,34,48,-14,20:15,Timrå IK
21.0,Joey LaLeggiaJ LaLeggia,D,52,9,29,38,24,0,1,144,5,39,40,63,-23,24:00,Timrå IK
91.0,*Viktor Lodin*V Lodin,F,44,12,15,27,45,2,3,115,54,11,27,32,-5,16:57,Timrå IK
94.0,Sebastian HartmannS Hartmann,F,49,14,11,25,12,3,2,106,31,18,30,44,-14,17:20,Timrå IK
44.0,Jacob BlomqvistJ Blomqvist,F,48,10,12,22,18,2,2,74,12,21,27,39,-12,16:02,Timrå IK
33.0,Albin LundinA Lundin,F,49,9,13,22,14,3,3,69,32,16,20,38,-18,16:46,Timrå IK
81.0,*Jens Lööke*J Lööke,F,49,8,13,21,10,1,3,94,38,16,18,31,-13,13:56,Timrå IK
10.0,Robin AlvarezR Alvarez,F,42,4,13,17,45,0,0,59,18,14,22,27,-5,15:08,Timrå IK
2.0,Per SvenssonP Svensson,D,52,6,10,16,10,1,0,62,135,76,33,43,-10,19:15,Timrå IK
11.0,*Nolan Zajac*N Zajac,D,52,3,12,15,14,0,2,56,6,39,31,43,-12,18:55,Timrå IK
19.0,Erik AnderssonE Andersson,F,51,3,10,13,0,0,0,47,19,18,21,31,-10,13:20,Timrå IK
46.0,*Pontus Åberg*P Åberg,F,24,5,6,11,36,1,2,60,1,3,10,16,-6,17:11,Timrå IK
24.0,Erik Walli-WalterholmE Walli-Walterholm,F,50,2,5,7,10,0,0,43,41,24,12,25,-13,9:00,Timrå IK
52.0,*Christopher Liljewall*C Liljewall,F,28,1,5,6,8,0,0,20,6,11,9,19,-10,12:46,Timrå IK
85.0,*Filip Westerlund*F Westerlund,D,50,2,3,5,4,0,0,47,15,24,21,36,-15,14:58,Timrå IK
32.0,*Jacob Olofsson*J Olofsson,F,18,1,4,5,0,0,0,14,1,3,5,9,-4,8:48,Timrå IK
24.0,*Oliver Bohm*O Bohm,D,30,0,5,5,8,0,0,17,12,19,6,15,-9,12:00,Timrå IK
4.0,Tim ErixonT Erixon,D,47,2,2,4,55,0,0,69,23,60,26,34,-8,20:05,Timrå IK
8.0,*Ziyat Paigin*Z Paigin,D,12,1,3,4,8,0,1,33,6,12,9,12,-3,23:53,Timrå IK
14.0,*Albin Carlson*A Carlson,D,29,2,1,3,8,0,0,14,2,15,6,8,-2,9:27,Timrå IK
23.0,Jeremy Boyce-RotevallJ Boyce-Rotevall,F,46,2,0,2,2,0,0,15,17,17,4,8,-4,5:38,Timrå IK
9.0,Didrik StrömbergD Strömberg,D,11,1,1,2,6,0,0,16,16,5,10,5,5,17:29,Timrå IK
29.0,*Morten Madsen*M Madsen,F,35,1,1,2,2,0,0,17,14,9,7,14,-7,8:39,Timrå IK
12.0,*Viktor Liljegren*V Liljegren,F,30,1,0,1,4,0,0,20,6,7,3,7,-4,5:32,Timrå IK
19.0,Noel EdfeldtN Edfeldt,D,1,0,0,0,0,0,0,0,0,0,0,0,0,0:00,Timrå IK
22.0,*Oskar Larsson*O Larsson,F,1,0,0,0,0,0,0,0,0,0,0,0,0,0:00,Timrå IK
7.0,*Gustav Lindström*G Lindström,D,1,0,0,0,0,0,0,0,0,0,0,0,0,0:00,Timrå IK
22.0,*Svante Nordberg*S Nordberg,F,1,0,0,0,0,0,0,0,0,0,0,0,0,0:00,Timrå IK
27.0,Oliver JohanssonO Johansson,F,14,0,0,0,0,0,0,16,1,2,0,7,-7,6:49,Timrå IK
